______________________________
|          #                 |
|          #                 |
|          |                 |
|__________|                 |
|                            |
|                            |
|                            |
|                            |
|                            |
|                            |
|                            |
|                            |
|                            |
|                            |
|                            |
|                            |
|                            |
|                            |
|                            
|____________________________|