______________________________
|          #         ^       |
|          #      ^  *   *   |
|          |^^^^^^^      *   |
|__________|      ^^^^^^^*   |
|                    ^       |
|                    ^       |
|           ^                |
|^^         ^                |
|           ^****************|
|                 ^          |
|       ^         ^          |
|       ^^^^^   ^            |
|             ^              |
|^^^**       ^     **^^^     |
|           ^        ***     |
|          ^  ^       *      |
|   ^^****    ^      *    ^^^|
|       *      ^     *       |
|                    *        
|____________________________|_