______________________________
|       |                    |
|       |   * * * * *        |
|       |     * * *          |
|###____|                    |
|                            |
|                            |
|                            |
|                            |
|                            |
|                            |
|                            |
|                            |
|                            |
|                            |
|                            |
|                            |
|                            |
|                            |
|                            |
|____________________________|_